1111111111111111111
4222222222222222234
1216121613161216121
1212121212121212121
1212121212121212121
1212121212121212121
1212121212121212121
1212121212121212121
1212121212121212121
1212121212121212121
1212121515121212121
1212121212121212121
1212121212121212121
1212121212121212121
1212121212121212121
1212121212121212121
1212121212121212121
1212121212121212221
1216131613161216111
1322222222222222131
1111111111111111111