1111111111111111111
1522222222222222221
1211212121212121121
1211212121212121121
1222222222222222221
1211212121212121121
1211212121212121121
1222222222222222221
4311316161616131134
1211212121212121121
1222222222222222221
1211212121212121121
1211212121212121121
1222222222222222221
1211212121212121121
1211212121212121121
1222222222222222221
1211212121212121121
1222222222222222251
1111111111111111111