11111111111111111111
12221222222211222221
42121611111226211121
12521223211111232221
12121211222222212121
12121222211111112121
12121121212222222121
12121121222121212121
12221121112121212221
12121222112121212121
12121212222122312221
12221222161121212121
12121112222221212121
12122221111122212224
12221121232112112121
12111222212612112121
12221211111212115121
12121222221212112121
12223211122222112221
11111111111111111111