111111111111111
122222262222221
131212131212131
121212121212121
122222222222221
121112111211121
122222212222224
111211252111211
112312212212211
112112111212111
422222212222251
121211222112121
121311212113121
121222212222121
122211262112221
111111111111111