1111111111111111
1122222222212221
1121121211222121
1122221211312121
1621122222222224
1211131121211111
1222222222223251
1211212121212121
1222222222612221
1111112111111121
1232222222112221
1212111112112121
4222222222222221
1512121211121211
1212121212221211
1222123222122611
1111111111111111