1111111111111111111
1122222252222222311
1121111111111111211
1222222222222222221
1212111111111112121
1222226363636222221
4211111111111111124
1222222222222222221
1212121212121212121
1222222222222222221
1211121212121211121
1322222222222222251
1111111111111111111