111111111111
422222222221
121312111151
122222122221
111111221121
122222212221
121121222111
125121112111
112222226324
122111211121
131222212221
122211222111
111111111111