11111111111111111111
16222221111122222221
12111121222221113121
12211222211122222221
11211212122211111121
42222212221612222121
12131112122212112321
12122222111212112121
12121112222212226121
12122222111222121221
12221212222212122211
12111211121112111211
16222222222222222211
11121113111211121111
12222212222222222221
12111222111112131121
12111112222222121231
12112321211112222211
12122122221222111211
12121112121212221521
12121112121212121121
16222212222212121121
11111222111252122224
11111111111111111111