11111111111111111111
15222222232222222221
12112111111111121121
42222111111111122224
12112111111111121121
12116222232222261121
12112121111112121121
12112121111112121121
12112121111112121121
12112622222222621121
12112121111112121121
12112121111112121121
12112121111112121121
12112122222222121121
12112121111112121121
12112121111112121121
12112122232222121121
12112121111112121121
12222222232222222251
11111111111111111111