11111111111111111111
15222112222112226151
42112112112112112124
12112222112222222221
13111111111111111131
12222112222112226121
12112112112112112121
12112222112222222221
13111111111111111131
12222222222222226221
11111111111111111111