1111111
1222261
1212124
1212121
1223221
1112111
1222221
1212121
1212131
4212121
1522221
1111111