11111111111111111111111
12222262622222222223221
12111211111121111111121
12111312222222222222221
12111212111111111111121
12222212222212223222221
12111211111212111111121
12111223222212222222224
12111211111212111111121
42222222222212222222251
11111111111111111111111