11111111111111111111
15222222222222222221
12112111211211121121
12132122222222123121
12221121211212112221
12111121211212111121
12222262222226222221
12121121111112112121
42121222222222212124
12222211311311222221
12111211311311211121
12222222222222222221
12111121111112111121
12222622222226222221
12111121211212111121
12221121211212112221
12132122222222123121
12112111211211121121
12222222222222222221
11111111111111111111