111111111111111111111
111122222252222221111
111321111111111123111
112212222222222212211
122122111121111221221
121221111131111122121
121212222222222212121
121212121212111212121
121212121212262212121
161212121212121216121
421212131312131212124
121212121212121212121
121212226222121212121
121212111112121212121
121212222222222212121
121221111111111122121
122132111111111231221
112212222222222212211
111321111121111123111
111122222222222221111
111111111111111111111