11111111111111111111111
12222222222222223222251
12121111112111211111121
12122222212221222122221
12111131211121112121121
12222221222122222123221
12111121112112121112121
42222223222222222222124
12111121112112121112121
12222122222112122232221
11112121112112111111121
12232122222262222221121
12111121111121111121121
12222222262262222222221
11111111111111111111111