111111111111111111111111
152222322221122222222224
121111211121121111111121
122222222121121222211221
111111112121121211222211
112222222121121222111111
122112121121121112122211
121222122261121222121221
121212121111126211221121
121222222221121222211221
126121111121121111111211
112222222221121222111331
111111211111122212111121
112222222221111622211121
122111111121111121222121
121222112221111122212121
122212122111111111112121
111122621222132211122621
122221121212121322221121
121111121212121111111121
122222622212132222222221
112112111122131313131121
142222222221133333333321
111111111111111111111111