1111111111111111111
1222222221222222221
1311211121211121131
1222222222222222221
1211212111112121121
1222212221222122221
1111211121211121111
1111216000006121111
1111210111110121111
1114200111110024111
1111210111116121111
1111216000000121111
1111210111110121111
1222222221222222221
1211211121211121121
1321222225222221231
1121212111112121211
1222212221222122221
1211111121211111121
1222222222222222221
1111111111111111111