111111111111111111111
162222232222222222261
121112111211111111121
121112222222222232221
421112121212121212121
121112121212121212121
122222232222222222221
121112121212121212121
131112222225222222221
121112121212121212121
122222121212121212224
121112222222222322121
121112121212121212121
121112121212121212121
122222222222222222131
121112121212121212121
121113222222222222121
131111111111111111121
162222222222322222261
111111111111111111111