11111111111111111111111
12621222162626122212621
12622222162226122222621
13331222122622122213331
13311122111211122111331
13111112222222221111131
11111111222222211111111
11122611122222111226111
42221211222122211212224
12122212221112221222121
12111222122222122211121
12122212221112221222121
12131111112521111113121
12122211222122211222121
12111211212221211211121
12122211222122211222121
16121111212321211112161
12122211222122211222121
12111211212221211211121
12122211622122611222121
12121111212221211112121
12122211222122211222121
12111211211111211211121
12222222222222222222221
11111111111111111111111