111111111111111111111
162212222132222122621
121212112121112121121
122232212121222122221
431211212261211121121
121211211111222232221
122223212223211121211
111111212111212222221
122222212222222112121
121111111211212112121
122222222222222222221
111111111111111111111
162212222122222122221
121212112121112121121
122222212121222122221
121211212321211121121
121211211111222232221
122322212252211121211
111111212111212222221
122222212222322112124
121111111211212112121
122222222222222222261
111111111111111111111